2 13 31
###############################
#p  x * **    *               #
# f # #*# # # # # # # # # # # #
#      ** * *  *   * **   *   #
# # # # # #*# # # # # # #*# # #
#*   * *    * * *   **        #
# # # # # # # # # # # # # #*# #
#    *     *        *    **  3#
# #*# # #*#*#*#*# # # # # #*# #
#        *   * *    *   *     #
#*# # # # # # # # # # #*# # #*#
#x*    * **    ** ***         #
###############################